o---o---o---o---o---o---o---o---o---o---o---o---o---o---o---o---o
|                                                               |
o   o   o   o   o   o   o   o   o   o   o   o   o   o   o   o   o
|                                                               |
o   o   o   o   o   o   o   o   o   o   o   o   o   o   o   o   o
|                                                               |
o   o   o   o   o   o   o   o   o   o   o   o   o   o   o   o   o
|                                                               |
o   o   o   o   o   o   o   o   o   o   o   o   o   o   o   o   o
|                                                               |
o   o   o   o   o   o   o   o   o   o   o   o   o   o   o   o   o
|                                                               |
o   o   o   o   o   o   o   o   o   o   o   o   o   o   o   o   o
|                                                               |
o   o   o   o   o   o   o   o   o   o   o   o   o   o   o   o   o
|                                                               |
o   o   o   o   o   o   o   o   o   o   o   o   o   o   o   o   o
|                                                               |
o   o   o   o   o   o   o   o   o   o   o   o   o   o   o   o   o
|                                                               |
o   o   o   o   o   o   o   o   o   o   o   o   o   o   o   o   o
|                                                               |
o   o   o   o   o   o   o   o   o   o   o   o   o   o   o   o   o
|                                                               |
o---o---o---o---o   o   o   o   o   o   o   o   o   o   o   o   o
|       |       |                                               |
o   o   o   o   o   o   o   o   o   o   o   o   o   o   o   o   o
|   |   |   |   |                                               |
o   o   o   o   o   o   o   o   o   o   o   o   o   o   o   o   o
|   |       |   |                                               |
o   o---o---o   o   o   o   o   o   o   o   o   o   o   o   o   o
| S | G         |                                               |
o---o---o---o---o---o---o---o---o---o---o---o---o---o---o---o---o
